1111111111111111111111111111111111
100000000000000C00000C000000000001
10100101001000001010010000000101C1
1010010010101010001001000000010111
1P0100000C00C00000000000000000E0C1
1111111111111111111111111111111111