1111111111111111111111111111111111
1E0000000000000C00000C000000000001
1010010X00100000X010010000000X0101
10100100X010X0X00010010000000X0101
1P0000000C00C0000000000000000000C1
1111111111111111111111111111111111