1111111111111111111111111111111111
100000000000000C00000C0000000000E1
1010010000100000001001000000000101
1010010000100000001001000000000101
1P0000000C00C0000000000000000000C1