111111111
1000C01E1
101CXC101
1P10C0001
111111111